12 12
WWWWWWWWWWWW
W..........W
W...W..WWWWW
W...W......W
W...WWWWW..W
W.W........W
W.W...WWW..W
W.WWWW..W..W
W.......W..W
W....WWW...W
W..........W
WWWWWWWWWWWW
